{
  "cols": 34,
  "rows": 30,
  "mask": [
    "###############....###############",
    "###############....###############",
    "###############....###############",
    "###............................###",
    "###............................###",
    "###............................###",
    "###............................###",
    "###............................###",
    "###............................###",
    "###............................###",
    "###............................###",
    "###............................###",
    "###............................###",
    "..................................",
    "..................................",
    "..................................",
    "..................................",
    "###............................###",
    "###............................###",
    "###............................###",
    "###............................###",
    "###............................###",
    "###............................###",
    "###............................###",
    "###............................###",
    "###............................###",
    "###............................###",
    "###############....###############",
    "###############....###############",
    "###############....###############"
  ]
}